
S	Textures/barrel.xpm

NO  Textures/redbrick.xpm
SO	Textures/wood.xpm

WE	Textures/mossy.xpm  
EA 	Textures/colorstone.xpm  


F	  Textures/Sand.xpm  
C	  Textures/sky.xpm 



R   800    1000    



1111111111111111111111
1000000000000000000001
1010000000000012000W0011
110000000000002000000001
1011111111111000111111110
11111111111111111111111